$ANSIBLE_VAULT;1.1;AES256
62346561353437393034386131636233333763356435303034376539663436343834393433633161
3562646435326165643139613532643666333263316231320a346432313161356338616263663936
36396461626233653963376130396532396162383637303633356335363964356336363036363931
6565616635316262620a313063663963643661393465313031343730643039313366613065633734
37306636663962616462343334386666356439613764313436383634633830663765383437353363
62613436633330626434616364316662663433353837613830633735646465656364316166316232
37303834316161343239633638633135656132323962616334386362656139336338333533393265
35613562313765626166
