$ANSIBLE_VAULT;1.1;AES256
62613337393266636265343839346235623361656336333634613037323930363339303336323463
3865313966646230616135313433323539316238633335640a633034313034373839346639623665
62313761343736383436303962363732326335386430343035346139616563393639626165386566
6130333035333832620a373564393061666461396534653838343064373839316638653965343932
32663762396264343333323461313334393934623239353538666132333164346363626630376130
61353138653563316663643330383530363861316430666465666362346531363231656262653239
66376566393134616230336366316434643664373863663561396334383965623762363566303965
62666164346336646461
